lawalhabs	
BINGBINGDELIGHT	
BIGBANG_Spain	Spain & South Korea
Pepelux	Sevilla
Hellmanns_Spain	España
5hofdallas	♡2/12 and 1/6♡ || Aitana.
worldinablock	Earth
NuriaRey91	Barcelona,Vila de Gràcia
AgniTravel	Web:
ZaaamDamn	
number_gamer	mexico
Laura_GlobalEd	USA
BIGBANG_Spain	Spain & South Korea
LuciaP2013	
BIGBANG_Spain	Spain & South Korea
Polestar_Spain	España
Los40_Spain	España
BloodyNightCon	Spain
BIGBANG_Spain	Spain & South Korea
BIGBANG_Spain	Spain & South Korea
chloephill_x	
TurismoEnTw	
Estherar1d	Priego de Córdoba
tronoxitotox	en TWITTER
PandaSecurityVE	Caracas-Venezuela
number_gamer	mexico
BIGBANG_Spain	Spain & South Korea
Rossers_Spain	España
LFC_DAN_RCCV	Liverpool, England
davydavy6	✿∀∆∑ ♥ ∀∑✿
sergiovillab	Asturias
itsrocioc	1/4 austin.·*✧
justacitycorner	all over the world
bydeluxespain	España
LisBuckingham	Rotherham
MBTotorika	
mihaimovilescu	Bucharest, Romania
palaro2	
PheThePhen	Canarias,Tenerife,Frikilandia
LoulouClient	
KeithMaxwell21	Somerset
Alex_cuello744	
suhaanarora	lucknow
coparota41	valladolid
777RJA	Portsmouth
_BrokenHeartZ	United Kingdom
garrixer_spain	
rimaanabtawi	Beaumont, TX
maquinavant	pel País Valencià des del 1999
IamSammyDavis	Columbus Ohio
orlando2525	
2015OMBaseball	
Spain_ImagineD	
Mary_from_Mars	Saint-Petersburg, Russia
Spain_0110	めんそりゅわーるど
ChiaraNiro	
ReninMontero	
PandaHonduras	Tegucigalpa, Honduras
KumfyTailz	Chicago/Worldwide
OCpethotel	Laguna Niguel, California
victoriadogs	Victoria BC
doglogue	The park - where else?
AndrCarpenter	London
Spain_0110	めんそりゅわーるど
GBabeuf	
KarenHenriques	Volta Redonda-RJ
Bot_Football	
TheFactkers	Philippines
FootballFurious	Planet Earth
MakiJuly0713	
Beatriz_spain	Guadalajara - España
Adriana_Nicolau	
PlaisirDuDesir	
Spain_0110	めんそりゅわーるど
peachydemi	
canariasgram	Canarias
lionelrossier	✚Switzerland 
spain_aphbot	スペイン
canariasgram	Canarias
DeanAFC1989	
Spain_0110	めんそりゅわーるど
Susn_	Trondheim, Norway
RattyNews	World Wide
girlymom4	Cincinnati, OH
patriciaarami	Ibiza/España
betabookings	
gunnerthoughts	London, England
inesrivero96	
Pards_79	Dog's Ville
sarpyokush34	居心地いい場所全般
Rossers_Spain	España
Spain_0110	めんそりゅわーるど
ivandomvar	Aspe
Roblesgj	Santa Barbara, Ca
ClassicGatto	MADE IN ITALY. noʎ ʞɔnɟ
spjagbaseball	
CNTLogrono	Logroño (La Rioja)
postmarkets	California
canariasgram	Canarias
iosulopez1	
