icakashita	Balifornia, Indonesia
SampeMuncrat	BALI
vamsikbolla	Visakhapatnam, Andhra Pradesh
nizAnizz	ÜT: -6.2232027,106.861986
Balitoday	Denpasar, Bali, Indonesia
Balitoday	Denpasar, Bali, Indonesia
Balitoday	Denpasar, Bali, Indonesia
Balitoday	Denpasar, Bali, Indonesia
Balitoday	Denpasar, Bali, Indonesia
Balitoday	Denpasar, Bali, Indonesia
Balitoday	Denpasar, Bali, Indonesia
adeanggy24	Denpasar, Bali
LeeVonLeft	
DUTAFM_BALI	Denpasar Bali
FerenBie	Pasuruan, East Java
_Rehaniaaa_	yk
Bali_Football	Football in paradise
muhammadaliiph	Nomadent
settyshine	Bandung
PrillverssBali	BALI
asmuransyah3	BANDUNG
TheReelStevie_J	Newark Delaware
diahputrirahyu	Badung, Bali
felippinhogcoo	
Adiarthaz	Gianyar - Bali - Indonesia
adehanura10	Yogyakarta
k_dan_bali	
Wayan_adi_bali	Denpasar, Bali
Bali_Football	Football in paradise
DUTAFM_BALI	Denpasar Bali
lyntapnio10	
SilangHati	IYH (In Your Heart)
anissaviyataw	
jaintina16	Mumbai
kidulkulon	Tribun Barat SSA
annisadeza	england
januarsidiq	Perum teluk jambie.
mumu87	ÜT: 3.117425,101.675834
PranandaTyas	Ig/Skype: PranandaTyas
xxxxmrlxxx	@tyler's
infoeventcb	indonesia
DUTAFM_BALI	Denpasar Bali
Amazing__Marie	BRONX NY..... Soundview baby
DoubleQuicktime	United States
_tashiax550	
xiaolanjpn	アジア／Asia／亜細亜
herrickandreas	
jcbme	Wilson,NC 
dorothycook123	
TirzaMonica1	Home
JonahPosts	Cikarang,East Java
OKKinderhook	US
JULPAIJI	
AriefBasariF	Depok
Amazing__Marie	BRONX NY..... Soundview baby
imFIRENZE	Virgo ♍
celoteh_BALI	
aryanikadek	Denpasar -bali 
SN_1	Indonesia
SN_1	Indonesia
PricelessBiebs	Watching netflix with Justin
AsyikIndONEsia	Jelajah Negeri
funimibk72__	Jakarta Selatan
funimibk72__	Jakarta Selatan
funimibk72__	Jakarta Selatan
funimibk72__	Jakarta Selatan
funimibk72__	Jakarta Selatan
BinMhammed	
ylstrlp	
RGifany	
Ika_Ikma	SMA NEGERI TEMPEH 
Hizkia_ID	
Hizkia_ID	
ngetwitsendiri	Indonesia
_indeksberita	Indonesia
mJo_sahputra	North side,Sidoarjo
DataHitam	Benfica, Portugal
IndoBerita_	Indonesia 
D4rm4nsy4h	Jakarta - Tebing Tinggi Deli
serbaserbiinfo	
BaliHalal	
MinSuryamin90	
StephanieStey	
tumbuhkan	Indonesia
COMPASS_UNUD	Kampus Sudirman Denpasar
geprok	Indonesia
beritik	Indonesia
paradetwit	Indonesia
situkonyol	Indonesia
ArikSantiari	Badung
tekiprik	Indonesia
adibumi20	Indonesia
TLCepat	bumi nusantara
beuhunik	Indonesia
unikbeuh	Indonesia
Mencekikmu	Indonesia
WoowGitu	Indonesia
ilhxam	Indonesia
athurwp	
Gabrelaaaa_	
