debbiex903_	
Bali_Maha	AUC, Cairo, #Egypt
Rezalliants_JKT	
Hilda_Dh2V	Jepara
alvin_style	
inten_balqis	Seoul - Makassar
puterabangsa	
dimskiloverssg	Singapore 
ceciliaflorenz	Jakarta, ID
MT_yulyulk	Multitalent_ent
DimasSatriod27	Not detected
ruririnuktii	Indonesia, Jakarta
EnamDealz	USA
bali_rhef	
SindyAlbilqis	
Luciabestue	
AndreasStevan03	Kediri - Indonesia
NyataBerita	Indonesia
Ngeser	Indo
inten_balqis	Seoul - Makassar
kikywuysang	Pontianak, West Kalimantan
SolBeachHouse	
PikamDeals	USA
Sitedealza	USA
antibodirock	Denpasar - Bali
millenita1	B.Lampung
endedhaivam	
inggadana	Jakarta selatan
JonahPosts	Cikarang,East Java
imaemuz	Malang
miladRHM	
AC_Bali	Denpasar, Bali
FeastBaliBridal	兵庫県神戸市
revistaxtrema	Caracas Venezuela
Suparat83757611	BKK
RealBali_com	Bali, Indonesia
EkaEkanov	Kota Tangerang 
GlocalWalk	✈ NOW IN BANGKOK ✈
bunny_bali	bikaner 
alyhandarto	Semarang, Indonesia
wisatalendir	Full-time promote!
nobaangs	Cagayan de Oro 
ISH_Bali	ÜT: -8.68598,115.234745
bali_rose_	(D)MV
ellaquisido	
bali_rose_	(D)MV
HighVoltTV	HighVoltTV.com@gmail.com
ChiaGraceiya_	
OFCkidholics2	2RLovers BogorBarat
Mediamusikcom	di dasar lubuk hatinya @unaputri 
jhntour	jakarta
RianaTante	
diah_purnama1	Denpasar,Bali
lovitaveronica1	jakarta
roni_az	-6.170278 106.824167
AndreasStevan03	Kediri - Indonesia
KidholicsSby	Surabaya - Jawa Timur
KepoMaximal_	Indonesia
SpikersKEPO	☎ Iklan/Ads 0‍81908947660 ‍ ‍
kutabaliku	
rei461	
chadexwirta	denpasar
songjoa	
RCI_Bali	Denpasar, BALI
rattna_andriya	Sleman, Yogyakarta
alvianaa14	
burupromo	Indonesia
KidholicsSby	Surabaya - Jawa Timur
areztde	ÜT: -6.934531,107.619153
Litharamadany	Malang , Jawa Timur
hendraa773	Palu
DeliaaAms	Bali
kyonaripatrice	Jakarta
ArianaJGrandee_	
Ajierlyson	
JeanClaronino	
FAJARxN	SURAKARTA INDONESIA 
harundjwe	indonesia
ARoss_10	
cllstdna	INDONESIA 
desynataliaput2	Sentolo, Yogyakarta
bunny_bali	bikaner 
ombak_pasang	Nomaden
bunny_bali	bikaner 
rizaltaktahu3	ambooonn 
QiqiWijayaa	
NorthWalesDirec	Colwyn Bay, North Wales
kiratjas	delhi
HidaMM14	
Calucaroo	
pijadventure	
elian_LFC	#LFC #YNWA 
KidholicsSby	Surabaya - Jawa Timur
mark_lucey	
AliefRhmnt	
k_dan_bali	
ridwansadja_tri	AgrowisataSt
MeejSulaiman	Brunei Darussalam
IklanTwitMurah1	
kura2guide	bali,indonesia
