BlandineDemay	
morgancbennett	
Judicaelsan	Gotham City
endirectocon	Boyacense
TomLabourdette	
ktraks777	
Chebilink	
aurigor64	
tru3ly__yours	
stylesftpalvxn	ACMT
theworldofstar1	
jakeybracktes	Texas
wtfswan	Santa Teresa, Espírito Santo
ilouu_	guadeloupe 
Ma___rine__	Maman 333
deigmar	São Paulo
HameedAnbar	
OreoCSGO	Tours/Paris
lolagogol2	 Paris 
soccercafe1	Upplands-Väsby, Sverige
thomas_smn1	#TeamPSG
tereretete	Portugal
AJC_Paris	Paris
tereretete	Portugal
hannahjwhatcott	AZ 
Sophspeaking	France
MHeraut	
CunninghamA_	Newcastle Upon Tyne/Lincoln
WRENERGETIC	between summer and autumn 
BEENOITLMR	
ResistFrance	Chnord Lycée Wallon #prépa
FWDSLXSH	London
Ikidde_	FC Barcelona 
babinmarine1	
NtHosselton	Chile
MHBachelier	Angers
TolGaZeer	Marseille
StevenTorossian	Je suis français de France.
cutemixer	agatherine
malefibloom	eastblue
ptipu_saladi	Gillette Wyoming
LaDeffs	
bukettoo	İzmir
ResistFrance	Chnord Lycée Wallon #prépa
TheFuture1210	Henderson, Colorado
kaylaannmecca	♍️ psalm 46:10
CeedricL	Paris
MMI_Troyes	#IUT, #Troyes, France
genc_besiktas	Beşiktaş
ParisPopup	Paris
DatzHott	Worldwide
oGSwaggyFresh	Compton, USA 
Dreyruby	france ✈️ PH & JDA
fassexperience	Lyon, France
Andeol_	
StanHintzy	Rennes & around the world
JehanneLldc	Cherbourg
Gagouthe	
OyeMusica	Latinoamerica
heffo21	
avxnty	Paris XV
BRYCEGIBSON7	Norwich
eatingstandard	London, United Kingdom
Paragon____	Everywhere
EmmaDlmt	
Paragon____	Everywhere
Paragon____	Everywhere
BingeVideo	
Paragon____	Everywhere
Paragon____	Everywhere
tcilemcoskun	Aydın - Ordu 
Dallas_6799	Mexico, Distrito Federal
EUHeadlinesNews	Europe
andreiis_05	
hayt99	#Saudi Arabia
EUHeadlinesNews	Europe
EUHeadlinesNews	Europe
fred_from_paris	www.humanitudons.com
Secrets_Travel	NYC LA SF HONG KONG JAPAN EURO
EUHeadlinesNews	Europe
EUHeadlinesNews	Europe
SammyjWaters	Newport, Wales
Niazkilam1234	Paris
etienne_fischer	
Maribel_Posadas	Paris - Córdoba- Madrid
mallau_ryna	Le Paradis, Lestrem.
omari_room	Omariville
andybere97	
Marie_Rdgz	Paris.
Paris__G	T.O(#Toronto),CDA IG: paris__g
PrayApp	
BenjaminMattely	Paris
RdeMontauban	
HeatMiser_	in the ocean 
itzelitavasquez	
AnnuaireParis	Paris
GENinnovate	Worldwide
kaelamartinez	
FrenchSpotlight	Newport Beach
PedaleaRevienta	Barcelona
