AnastasyaNadeak	Denpasar, Bali
AnastasyaNadeak	Denpasar, Bali
AnastasyaRPA	segitiga bermuda
AnayArvan	ÜT: -6.2797,106.92665
And_Faiz	Jakata-Endonesyah
AndaraStars	Andalucía, SPAIN
AndeLyons	Boston, MA
AndersPlusHort	London 
AndersenMyriam	
AndhikaFebriana	ÜT: -8.540641858839972,115.270
AndhyValery	Jambi
AndiAshockk	Makassar
AndiRossaF	Soppeng • Makassar • Pangkep
AndiniDP1	Tuban, Jawa Timur, Indonesia
Andishridivian	Makassar
Andisuparmaan	KOASS @RS HAMS Kisaran
AndrasKajari	
AndreBaraBere2	CIREBON - PADANG - INDONESIA
AndreBaraBere2	CIREBON - PADANG - INDONESIA
AndreBaraBere2	CIREBON - PADANG - INDONESIA
AndreBaraBere2	CIREBON - PADANG - INDONESIA
AndreBaraBere2	CIREBON - PADANG - INDONESIA
AndreBaraBere2	CIREBON - PADANG - INDONESIA
Andre_Allbert	Indonesia - Jakarta Selatan
Andre_Rvmusic	Banda Aceh-jakarta-indonesia
AndreaAta13	Toronto
Andrea_Onigiri	
Andreais4real	 jelenasgossipcop 
Andredelcocco	
Andrei60usl	
Andrei_Lemi	
Andreiaa_L	PORTUGAL
AndrewAlfian	Semarang , Indonesia
AndrewMoir5	
AndreySidorin	Russia
AndriWijayaTTHP	S 6� 9' 0'' / E 106� 46' 0''
AndrianApr_ID	Bogor
AndySpeed98	
Andycoolll	
AngelPacc	#txst
Angel_KusumaP	Surakarta, Indonesia
Angel__AHRI	
AngelaRoquet	Sedalia, MO
Angela_Harkness	Every where 
AngeliaVannesa	jakarta
AngelinaLivia	Indonesia
Angelnathly	Kuta Badung (BALI)
Angga94069001	Bandar lampung
AnggaEyldn	Pontianak
AnggaMaliks	Bali | Makassar ॐ
AnggaPitor_	
AnggaSoedjana	Pangkalan Bun - Semarang
Angga_Rosyanta	mengwi - badung
Anggaraadji_s	インドネシア
AnggerSchlyzer	indonesia
AnggerSchlyzer	indonesia
AnggerSchlyzer	indonesia
AnggerSchlyzer	indonesia
AnggerSchlyzer	indonesia
AnggerSchlyzer	indonesia
AnggerSchlyzer	indonesia
AnggerSchlyzer	indonesia
AnggiDre	
AnggiLKswr	
AnggitaKHW	
Anglkk	Cali-COLOMBIA 
AngusBlair1	Cairo
AnichMariana	
Animal_Buddha	
AnisResti_2	Brebes
AnisaSlsbl_N	
Anisa_dhini1	bandarlampung,INA
Anisahmda_	Pahang  ♡
Anissa_Ismail	Banjarmasin
Anistya01	Indonesia 
Anisulfuad10	KENDAL - INDONESIA
Anitadya98	Malang , Indonesia
AniyulianiGmail	Bumi ALLAH
AniyulianiGmail	Bumi ALLAH
AnjuRupal	Switzerland 
AnnCappe	
AnnGagne	
AnnGagne	
AnnGagne	
AnnGagne	
AnnGagne	
AnnGagne	
AnnGagne	
AnnGagne	
AnnaEarl6	
AnnaWuri	
AnneJames22	Southern AZ
Anni_insan	Pamekasan
AnnisKRN	
AnnisaAppe	Seoul Korea Selatan
AnnisaKraihanna	Bastard
AnnisaPuriA	
Annisa_zuliaW	Surakarta 
AnnisyaFarah	KEDIRI, INDONESIA
AnnoyingBel	+65
