AlejandroMren	Cancún 
AlejandroMren	Cancún 
AlejandroMren	Cancún 
Alema26809433	
AlenDhoank	alendhoank@gmail.com
AlexAlDel	France
AlexUnder9602	
AlexWodak	Sydney, Australia
AlexaNasara	
AlexandraJanna	nowhere, anywhere, everywhere
AlexandraJanna	nowhere, anywhere, everywhere
AlexandraJanna	nowhere, anywhere, everywhere
AlfiCieh	Indonesia, Medan
AlfiElfSllu	Tulungagung Jawa Timur Indones
AlfiElfSllu	Tulungagung Jawa Timur Indones
AlfianNur28	
AlfieReza_21	Jakarta • Indonesia
AlfinDong	Batam Island :)
Alfisyahraaa	Jakarta
Alfiya_ilfa06	Kudus, Jawa Tengah, Indonesia
AlgrisTiepi	Kudus 
AliFaizMukti	Bandar Lampung
AliM3dina	NYC
Aliandooo26ID	
Aliesadahmer	Here,there,everywhere
AlifIzmeer	Penang Islands,Malaysia
AlifiaKautsar	
AlilaManggis	East Bali, Candidasa
Alin0204	balikpapan, indonesia
Alindaa138	Purwodadi , Grobogan
Alipyainii	
AlissiaStott	Doha, Qatar
Alittledogduck	
Alkunana	Bandung
AllAboutYoona	
AllSuperHero	Jakarta
Allaboutsazzle	Southerner living in Yorkshire
AllissonH	
Alljoe1423	
AlluringAlissa	
Ally_Bali	Ontario, Canada
AlmerFP	@KrangganPermai 
AlokGup77503129	
Alonxii_LC_02	Santiago, Chile
Alpaaaaaa	
AlphaScout1324	
Alprilvers_bali	
Alshalover_fc	
AltamuraMola	
Alvindrs	Line: alvindrs
Alvinhariyadi	Indonesia
Alyshah_BAli	Madrid, Spain
Alyshah_BAli	Madrid, Spain
AlysiaHamilton	Vancouver, BC
AmadAbd	Denpasar, Bali - Indonesia
AmadAbd	Denpasar, Bali - Indonesia
Amakawaii	ÜT: 0.50966,101.45967
AmaliadwiAmell	Magelang
AmandaKingsmith	
AmandaRachelV_V	GOD'sBeautifulEarth (UK x MAS)
AmandaZufolo	NYC
Amandaniharaa	Los Angeles 
AmartyaSaputra	Kota AirMolek
AmbangInsidE_	Lippo Cikarang
Ambang_69	bandung
Amber_041589	Vancouver Canada
Amber_IRP	[#OT∆KU]
AmeeTweets	Tøkÿò , Jâpáñ
Amel_Ame08	indonesia
Amel_Rifah	Banjarmasin || INDONESIA
AmeliaCapshaw	Seattle Grace Hospital
AmeliaShaffira3	Jakarta, Indonesia 
Amelia_DwiS	Batam - Semarang
AmeliamiaF	DKI jakarta
Ameliangraini	Tangerang
AmelliaMels	Permata hijau, Jaksel
AmerahQ	     
Amhelia_Rizky	Indonesia_SulSel_Makassar
AmiReny	 Lubuklinggau-sumsel
AmiaSovitami	LettuSubagio22
AmilieK	
Amiprivate	Brazil
AmitV_Tweets	India
Ammarulls	Ny. United State
Ammazoners_Riau	riau
Amndastywt_	
AmparosNick	Los Angeles
AmyDursley	London 
AmyFlame	Somerset
AmyLune96	Bromsgrove
Amzarblack	kolaka
An99unwy	Nusa Dua,Bali
Ana_Mariabomo	México
Ana_setyowati27	Palembang, Sumatera Selatan
AnakAgungMia	Bali
Anakkbola	
AnandaSastra	Seminyak-Kuta-Badung-Bali
AnandaW2	Kabupaten Ponorogo
Anang_Pamungkas	Semarang Timur
AnasMahiwal	
