AU_NewsWaver	Australia
AWETour	MALANG
AWRanggi	SAN SIRO , MILANO 
AYAlovesMICKY	TOKYO
AZBcreative	Sydney, Australia
A_Hermansya_s	MAKASSAR - INDONESIA RAYA
A_Ribhan31	
A_Weeden	Alexandria, VA
A_besaaaar	Surga Firdaus :)
AabdillahP	
AaleyaOmar	Johannesburg, South Africa
Aam_VJIN	facebok.com/aam
AanCblack	
AandLCambodia	Kampot, Cambodia
AangRiyansah1	
Aang_syarifudin	ARAFAH NET&RELOAD
Aaronsteve2	Jakarta Indonesia
AasihTC	
Aaynaayna	Land below the wind, 920
AbazzMahardika	Beng Gianyar Bali
Abby29_LoveTaha	@Youseftaha04 's Heart 
Abby_Bennett21	
Abbyours_Bali	since [01-03-15]
Abbyours_Bali	since [01-03-15]
Abbyours_Bali	since [01-03-15]
Abbyours_Bali	since [01-03-15]
Abbyours_FC	
AbdieLubis	Medan Sumatra Utara
Abdie_Ilahie97	SMK SASMITA JAYA 1
AbdulGiawa	
AbdulRasid389	sesayap hilir
Abdul_mujibbb	Pademangan, DKI Jakarta
Abdul_mujibbb	Pademangan, DKI Jakarta
AbdullahSurayhi	Jeddah-Al nuzha district
Abdun_muchlis12	Banjarmasin
Abell_PLUR	Bogor-Subang
Abigail2988	World at my feet
AbilNabawi	Rain City
Abimbe	Depok
AburzanArlam	
AcTiOn_MaRv	
AccessFashion	LONDON | US
AcehHebat_	Serambi Mekkah - Aceh ID
AcelMontolalu	
AchiPasha	Surabaya, Indonesia
AchiPasha	Surabaya, Indonesia
AchmadE71602750	
AchmadYSaputra	
AciJasmine	
AcikAmeera	taiping
AcilXavi	
Acsands	
ActorWoob89	SidusHQ ㅡ S. Korea
AdNear	Singapore
AdSiregar	In your imagination
AdSiregar	In your imagination
Adam64518720	
AdamCoo64216897	
AdamgasmAussie	200kliks from sanity Australia
Adamjulmi17	buitenzorg
AdanAldef417	Sudirman, Palembang
Addicted_Inv	
AdeHernawati_7	Kuningan - Bogor
AdeIrzaR	Bekasi, Jawa Barat, Indonesia
AdeNurlaela16	Bandung
AdeSieva	Jakarta,Indonesia
Adeeenn_	
AdeleVernanda	
AdetyaSrg_	Kisaran kab asahan prov sumut
AdheliaMW	
Adhen_21Guns	Sentul city
Adhiprawika	jayapura
AdiMCTD	Old trafford, manchester
AdiN_sARTONo	Tangerang banten
AdiT_Theaa	Yogyakarta
Adi_chuakers	Banjarnegara
Adi_dekills	Surabaya 
Adiestic	Banyuwangi,jatim
Adiffa_Diful	Purwokerto,Jawa Tengah
AdinDuana	
AdinRioAis	Lampung
Adinda_POF	
Adindamry	▶PINKBLUE◀
AdingPhoto	Melbourne AU and Jakarta ID
AdingPhoto	Melbourne AU and Jakarta ID
AdinolfiEnzoarc	Salerno
Adiprasetyaa	ÜT: -6.223819,106.824977
AdityaChoya	jakarta
AdityaWanted805	
Adityajtw	
Adityar4_	Indonesia
Adjie_TheJack	Jelambar - Wijaya Kusuma
AdnyanaAri	di tengah hiruk pikuk denpasar
AdorabelPicts	Indonesia
Adorabel_Bali	Denpasar , Bali
Adorabel_Bali	Denpasar , Bali
Adorabel_Bali	Denpasar , Bali
Adorabel_Bali	Denpasar , Bali
Adorabel_Bali	Denpasar , Bali
Adorabel_Bali	Denpasar , Bali
